@##################
o    #          $ #
#    #          $ #
#    #   !  #   $ #
#    #      #   $ #
#    #      #     _
#    #      #     #
#           #     #
#    $$$$   #     #
###################

+###
#  #
####

*##############
#             #
#             #
#             #
###############

