###################
o    #          $ #
#    #          $ #
#    #   !  #   $ #
#    #      #   $ #
#    #      #     _
#    #      #     #
#           #     #
#    $$$$   #     #
###################

####
#  #
####

###############
#             #
#             #
#             #
###############

